#################################################
#                                               #
#                                               #
#                 ###########                   #
#                 #         #                   #
#                 #         #                   #
#                 #         #                   #
#                 ###########                   #
#                                               #
#                                               #
##############                 ####################################
#                                               #                 #
#                                               #                 #
#                                                                 #
#                                                                 #
#                                                                 #
#                                                                 #
#                                               #                 #
#                                               #                 #
###########################         ###############################
