###################################################################
#                                                                 #
#                                                                 #
#                                                                 #
#                                                                 #
#                                                                 #
                                                                  #
                                                                  #
                                                                  #
                                                                  #
                                                                  #
#                                                                 #
#                                                                 #
#                                                                 #
#                                                                 #
#                                                                 #
#################         ###########          #######         ####
#            #                 #                  #               #
#            #                 #                  #               #
#            #                 #                  #               #
#            #                                    #               #
#            #                                    #               #
#            #                                    #               #
#                              #                  #               #
#                              #                  #               #
###################################################################
