###########################         #############
#                  #                            #
#                  #                            #
#                  #                            #
#                  #                            #
#                  #                            #
#                  #                             
#                  #                             
########       ###############                   
#                                                
#                                                
#                                               #
#                                               #
#                                               #
#                                               #
###############             #####################
#             #                        #        #
#             #                        #        #
#             #                        #        #
#                                      #        #
#                                      #        #
#                                               #
#             #                                 #
#             #                                 #
#             #                                 #
#################################################
