###########################         #############
#                  #                            #
#                  #                            #
#                  #                            #
#                  #                            #
#                  #                            #
#                  #                             
#                  #                             
########       ###############                   
#                                                
#                                                
#                                               #
#                                               #
#                                               #
#                                               #
###############            ######### ############
#             #            #           #        #
#             #            #           #        #
#             #            #           #        #
#                          #           #        #
#                          #           #        #
#                          #                    #
#             #            #                    #
#             #            #                    #
#             #            #                    #
#################################################